nurture = pečovat, rozvíjet
defeat = porážka, prohra, porazit
persue = věnovat se, provozovat
neglect = opomenout
downside = nevýhoda, zápor
tiny = maličký, drobný
feasible = proveditelný, realizovatelný, uskutečnitelný
cougar = puma (šelma)
trap = past, léčka
obey = poslouchat, (u)poslechnout koho/co, řídit se čím, dodržovat pravidla
emphasis
sour = kyselý / zhořknout , ztrpknout , pokazit (se)
facilitation = usnadnění , ulehčení čeho, napomožení čemu
examine = přezkoumat, zvážit
bargain = vyjednávat, smlouvat
entail = znamenat, způsobit(ovat)
strive = usilovat
foster = podporovat, pečovat o někoho
verge = blížit se, hraničit s
dare = odvážit se, troufat si
seek = hledat, vyhledávat
relieved = oddedchnout si, ulevit se, I'am relevied = to se mi ulevilo, to jsem si oddechl
facilitate = usnadnit, ulehčit
stakes = kapitálový podíl
stake = nárokovat, uplatnit svůj nárok
stakeholder = zainteresovaná osoba
relief = úleva, pocit ulehčení
induction = uvedení , zasvěcení (do nové práce ap.)
accountability = (z)odpovědnost
overly = (přes)příliš, (až) moc
adhere = držet se čeho, dodržovat (pravidla, zákony ap.)
procurement = nákup (oddělení nákupu)
conduct = chování
embrace = obejmout (se), vzít do náručí koho / přijmout, osvojit si co
entrail = mít za následek, znamenat
obtain = získat co, dosáhnout čeho
indiscriminately = zcela nahodile, hlava nehlava
diminished = zmenšený, snížený, omezený
regardless = 	bez ohledu na co, stejně, i tak, přesto navzdory všemu
legacy = dědictví, odkaz
go through = projít, probrat
straightforward = přímočarý , jasný , přímý
governance = řízení , správa (firmy)
outcome = výsledek
beyond = mimo
beyond that = mimo to
break = rozdělit, rozpadnout
roll up = tie or bundle - zabalit, svázat dohromadi
otherwise = v opačném případě
distinguish = rozlišit
initialy = zpočátku
subsequently = následně
to deliberate = rokovat, radit se
confident = jistý
stun = ohromit, omráčit
curious = zvědavý | divný
struggle = usilovat, bojovat
acquitted = osvobozen, zproštěn viny
outage = výpadek ... Influencers react to Instagram's big outage: 'It was a pain'
more-less = více-méně
pace = tempo, rychlost
puzzled by = zmatený
to yell = křičet, vykřiknout
imply = znamenat, naznačovat
span = překlenout nebo rozměr, rozsah
propensity = sklon k (ve smyslu inklinovat), náchylnost
withdraw = ustoupit, odvolat
insist / persist / last = trvat
bother = trápit, obtěžovat
compelling = přesvědčivy
devote = věnovat
deputy = zástupce
decent = slušný, ucházející
stack = skládat
certain = určitý, nějaký
reflect = přemýšlet, uvažovat
reinforce = posílit
